R 1920 1080
NO ./path_to_the_north_texture
SO ./path_to_the_south_texture
WE ./path_to_the_west_texture
EA ./path_to_the_east_texture
S ./path_to_the_sprite_texture
F 220,100,0
C 225,30,0








111
101
111
111111111111111111111111111111
1111111100000000000111100001
1000000000000001111111111111
1000000000000002
1000001000100001
1000010000010006
1100001000100001
1000000000000001
1000000000000001
1111411411411511
